NO 				./assets/texture_2.xpm
			SO ./assets/texture_32.xpm
WE 						./assets/texture_5.xpm
EA ./assets/texture_26.xpm

F 0,0,0
C 0,0,0

         11
        1001
       100001
      10000001
     1000000001
    100000N00001
   11111111111111