F 21,21,21
EA ./assets/wall/texture_39.xpm
WE 						./assets/wall/texture_39.xpm
C 21,21,21
NO 				./assets/wall/texture_23.xpm
			SO ./assets/wall/texture_29.xpm



1111111111111111111111111
100000000000000000000000111111111111111111111111111111111111
100000000000000000000000000000000000000000010101010100000001
100000000000000000000000000000000000000000001010101000011001
100000000000000000000000000000001111111110000000000010000001
111111110000000000000011111111111000000111111111100011111111
100000000000011100000100000000000001000000000000000000000001
100000001000000000010000000011111111111111111111111111111111
100000000X0000000010000001111
1000100000000X111111110100001
10000000000000000000000000001
11111111111110011111111111111
10000000000000000000000000001
1E000000000000000000000000001
11111111111111111111111111111
