NO 				./assets/wall/texture_43.xpm
			SO ./assets/wall/texture_32.xpm
WE 						./assets/wall/texture_16.xpm
EA ./assets/wall/texture_26.xpm

C 172,21,237
F ./assets/wall/texture_15.xpm


1111111111111111111111111
1000000000110000000000001
101100000111000000S00000111111111
100000000000000000000000000000001
111111111011000000110000010000001
100000000011000000000111111111111
11110111111111011100000010001
11110111111111011101010010001
11001000110101011100000010001
10000000000000001100000010001
1000000000000001101010010001
11000011101010111110111100111
11110111 1110101 101111010001
11111111 1111111 111111111111