F ./assets/floor/floor.xpm
EA ./assets/wall/texture_39.xpm
WE 						./assets/wall/texture_39.xpm
C 10,10,10
NO 				./assets/wall/texture_23.xpm
			SO ./assets/wall/texture_29.xpm



111111111111111111111111111111111111111111111111111111111111
10000000000000000000X000111111111111111111111111111111111111
1000001111000000000000X0001X0X1000X00X0000010101010100000001
1000X000010000000100X00000010100000X00X0000010101010X0011001
1000001101000X00000000000000X000111D1111100X00000000100X0001
11111111010000000000001111111111100X0001111D1111100011111111
10000000011011111000010000X00000000100000000000000X000000001
100001111XD00X0000010000000011111111111111111111111111111111
10000100001100X0001000X001111
1000110111111111111111D111111
10X000000000000000000000X0001
11D111111111111111111111D1111
10000000000000000000000000001
1E000000000000000000000000001
11111111111111111111111111111
