NO 				./assets/texture_2.xpm
			SO ./assets/texture_32.xpm
WE 						./assets/texture_16.xpm
EA ./assets/texture_26.xpm

C 172,21,237
F 204,237,57


1111111111111111111111111
1000000000110000000000001
101100000111000000000000111111111111111111111111111111111111
100000000000000000W00000000000000000000000000000000000000001
111111111011000001110000010000001111111111111101111111111111
100000000011000010000111111111111111111111111100011111111111
111111111111111111111111111111111111111111110000000111111111
111101111111110111000000100011111111111111111111111111111111
11110111111111011101010010001
11001000110101011100000010001
10000000000000001100000010001
1000000000000001101010010001
11000011101010111110111100111
11110111 1110101 101111010001
11111111 1111111 111111111111