NO ./path_to_the_north_texture
SO ./path_to_the_south_texture
WE ./path_to_the_west_texture
EA ./path_to_the_east_texture

F 220,100,0
C 225,30,0

         11
        1001
       100001
      10000001
     1000000001
    100000N00001
   11111111111111