F 21,21,21
EA ./assets/wall/texture_39.xpm
WE 						./assets/wall/texture_39.xpm
C 21,21,21
NO 				./assets/wall/texture_23.xpm
			SO ./assets/wall/texture_29.xpm

         11
        10X1
       100001
      10000001
     1000000001
    100000N00001
   11111111111111