NO 				./assets/texture_2.xpm
			SO ./assets/texture_32.xpm
WE 						./assets/texture_16.xpm
EA ./assets/texture_26.xpm

C 172,21,237
F 204,237,57


1111111111
1000000001
1111000001
100000N001
1000001001
1010001011
1000010101
1111111111
